S - - - - - - - - - |
| B B | B B B B | B |
| B B | B B B B | R |
| B B | B | - - | B |
| B B - - - B B | - |
| B B B B | B B | H |
| - - - - | - - | B |
| B B B B | B B | B |
| B B B B - | B | B |
| B B B B B | B | B |
| - - - - - - - - - P


